R 1000 1000
NO ./image_texture/test.xpm
SO ./image_texture/test1.xpm
WE ./image_texture/test2.xpm
EA ./image_texture/test3.xpm

S ./image_sprite/test0.xpm
F 220,100,0
C 225,30,0

111111111111111111111111111111111
111111111000000001110000000000001
111111111011000001110000000000011
111111111001000000000000000000001
111111111011000000000000000000011
100000000011000000000111111111111
111100000000000000000000100011111
111100000000000000000100100011111
110000000002000000000000000011111
10000000000000N000000000000011111
100000000000000011010100000111111
110000011101010110000000000000011
111101111111010111000000000011111
111111111111111111111111111111111