R 1000 1000
NO ./path_to_the_north_texture
SO ./path_to_the_south_texture
WE ./path_to_the_west_texture
EA ./path_to_the_east_texture

S ./path_to_the_sprite_texture
F 220,100,0
C 225,30,0

111111111111111111111111111111111
111111111000000001110000000000001
111111111011000001110000000000011
111111111001000000000000000000001
111111111011000000000000000000011
100000000011000000000111111111111
111100000000000000000000100011111
111100000000000001010100100011111
110000000000000000000000100011111
100020000000000000000000100011111
100000000000000011010100100011111
11000001110101011111011110N011111
111101111111010111011110100011111
111111111111111111111111111111111