R   100 100  
NO		./image_texture/test.xpm
SO ./image_texture/test1.xpm
WE ./image_texture/test2.xpm
EA ./image_texture/test3.xpm
S ./image_sprite/test0.xpm

F 238 , 238 ,238

C 194, 70, 70

111111111111111111111111111111111
111111100000000111000001000000011
111111111011000001110001000001011
111111111001000000000000000000001
111111111011000000000000000000011
100000000011000000000111111111111
111100000000000000000000100011111
111100000000002000000000000001111
110000000000200000000000000011111
10000000000020N000000000000011111
100000000000000011010100000111111
110000011101010110000000000000011
111101111111010111000000000011111
111111111111111111111111111111111