R 1000 1000
NO ./image_texture/test.xpm
SO ./image_texture/test1.xpm
WE ./image_texture/test2.xpm
EA ./image_texture/test3.xpm
S ./image_sprite/test0.xpm
F 209,209,209
C 23,236,255


11111111111     1111111111      1111111111     1111111111111111111111111111
11111111111     1111111111      1111111111     1111111111111111111111111111
11S00000001     1100000001      1000000001     1000000000000000000000000001
11000000011     1100000001      1000000001     1000000000000000000000000001   
11000100001     1000000011      1000000001     100000000011      0000000001
11000000011     1100000001      1000000001     100000000011      0000000001
11000000011     1100000001      1000000001     100000000011      0000000001
11000000011     1100000001      1000200001     100000000011      0000000001
11000000011     1100000001      1000000001     1000000000000000000000000001
11000000011111111100000001      1000000001     0000000000000000000000000001
110000200000002000000000020000000000000000000000000000000000000000000000001
11000000011111111000000011      1000000001     1000000000111111111111111111
11000000001111111100000001      1000000001     10000000001
11000000001     1100000001      1000000011     10000000001
10000000001     1100000001      1000000011     10000000001
10000000001     1100000001      1000000011     10000000001
10000000001     1100000001      1000000011     10000000001
11000000001     1100000001      1000000011     10000000001
11000000001     1100000001      1000000011     10000000001
10000000001     1110000001      1000000001     10000000001
10000000011     1000000001      1000000001     10000000001
11000000011
10000000011     1000000001       1111111111111111111111111     1111111111111111111111111111111
10000000011     1000000001       1000000000000000000000001     1110000000000000000000000000011
10000000011     1000020001       1000000000000000000000001     1100000001000000000000000000001
10000000011     1000000001       1000000000000000000000001     1100000000000000000000000000001
11000000011     1000000011       1000000000000000000000001     1100000000000000000000000000001
11000000011     1000000001       1000000011     1100000001     11000000011          1111001111
11000000011     1000000001       1000000011     1100000001     11000000011          1111000001
11000000011     1000000001       1000000011     1100000001     11000000011          0000000001
11000000011     1000000001       1000000011     1100000001     1100000000000000000000000000111
11000000011111111100000001       1000000000000000000000001     1100000001000000000000000000001
1100000000000000000000000000000000000000000000000000000000000000000000000000000000000000000001
11000000010000000000000111       1000000000000000110000000     1000000000000000000000000000011
11000000000000001100000001       1100000001     1100000001     1000000000011111111111111111111
11000000011     1100000011       1100000001     1100000001     10000000001
11000000011     1100000011       1100000001     1100000001     10000000001
11000000011     1100000011       1100000000000000000000001     10000000001
11000000011     1100000011       1100000000000000000000001     10000000001
11000000011     1100000011       1100000000000000000000001     10000000001
11000000011     1100000011       1000000000000000000000001     10000000001
11111111111     1111111111       1111111111111111111111111     11111111111
11111111111     1111111111       1111111111111111111111111     11111111111